A-PE-0-2
B-PE-0-4
C-PE-3-3
D-PR-4-5
E-PE-5-9
F-PE-5-3
G-PR-9-0
H-PR-10-6
I-PR-5-4
